,date,state,positive,negative,positiveIncrease,negativeIncrease,death,deathIncrease,totalTestResultsIncrease,totalTestResults,recovered,Percentage,Active Cases
18,9/2/2020,KS,43940,375307,1328,4670,458,12,5998,419247,1730,22.14%,41752
34,9/2/2020,NJ,192595,2709672,305,42914,15937,0,43219,2902267,33991,0.71%,142667
74,9/1/2020,KS,42612,370637,0,0,446,0,0,413249,1673,0.00%,40493
90,9/1/2020,NJ,192290,2666758,330,800,15937,0,1130,2859048,33949,29.20%,142404
130,8/31/2020,KS,42612,370637,1564,8538,446,3,10102,413249,1673,15.48%,40493
146,8/31/2020,NJ,191960,2665958,349,21235,15937,0,21584,2857918,33912,1.62%,142111
186,8/30/2020,KS,41048,362099,0,0,443,0,0,403147,1658,0.00%,38947
202,8/30/2020,NJ,191611,2644723,291,28296,15937,4,28587,2836334,33893,1.02%,141781
242,8/29/2020,KS,41048,362099,0,0,443,0,0,403147,1658,0.00%,38947
258,8/29/2020,NJ,191320,2616427,349,58204,15933,3,58553,2807747,33827,0.60%,141560
298,8/28/2020,KS,41048,362099,1111,6939,443,6,8050,403147,1658,13.80%,38947
314,8/28/2020,NJ,190971,2558223,358,0,15930,9,358,2749194,33778,100.00%,141263
354,8/27/2020,KS,39937,355160,0,0,437,0,0,395097,1624,0.00%,37876
370,8/27/2020,NJ,190613,2558223,307,26945,15921,7,27252,2748836,33744,1.13%,140948
410,8/26/2020,KS,39937,355160,1536,6604,437,11,8140,395097,1624,18.87%,37876
426,8/26/2020,NJ,190306,2531278,285,23404,15914,10,23689,2721584,33692,1.20%,140700
466,8/25/2020,KS,38401,348556,0,0,426,0,0,386957,1535,0.00%,36440
482,8/25/2020,NJ,190021,2507874,302,20781,15904,4,21083,2697895,33646,1.43%,140471
522,8/24/2020,KS,38401,348556,1545,19097,426,7,20642,386957,1535,7.48%,36440
538,8/24/2020,NJ,189719,2487093,225,27589,15900,3,27814,2676812,33626,0.81%,140193
578,8/23/2020,KS,36856,329459,0,0,419,0,0,366315,1520,0.00%,34917
594,8/23/2020,NJ,189494,2459504,258,0,15897,3,258,2648998,33615,100.00%,139982
634,8/22/2020,KS,36856,329459,0,0,419,0,0,366315,1520,0.00%,34917
650,8/22/2020,NJ,189236,2459504,419,32629,15894,2,33048,2648740,33555,1.27%,139787
690,8/21/2020,KS,36856,329459,966,5509,419,8,6475,366315,1520,14.92%,34917
706,8/21/2020,NJ,188817,2426875,290,30195,15892,9,30485,2615692,33533,0.95%,139392
746,8/20/2020,KS,35890,323950,0,0,411,0,0,359840,1472,0.00%,34007
762,8/20/2020,NJ,188527,2396680,100,27395,15883,6,27495,2585207,33490,0.36%,139154
802,8/19/2020,KS,35890,323950,723,4855,411,6,5578,359840,1472,12.96%,34007
818,8/19/2020,NJ,188427,2369285,329,24638,15877,11,24967,2557712,33451,1.32%,139099
858,8/18/2020,KS,35167,319095,0,0,405,0,0,354262,1409,0.00%,33353
874,8/18/2020,NJ,188098,2344647,331,21344,15866,10,21675,2532745,33403,1.53%,138829
914,8/17/2020,KS,35167,319095,1282,9937,405,3,11219,354262,1409,11.43%,33353
930,8/17/2020,NJ,187767,2323303,312,20572,15856,4,20884,2511070,33381,1.49%,138530
970,8/16/2020,KS,33885,309158,0,0,402,0,0,343043,1399,0.00%,32084
986,8/16/2020,NJ,187455,2302731,13,28790,15852,2,28803,2490186,33320,0.05%,138283
1026,8/15/2020,KS,33885,309158,0,0,402,0,0,343043,1399,0.00%,32084
1042,8/15/2020,NJ,187442,2273941,278,31264,15850,7,31542,2461383,33264,0.88%,138328
1082,8/14/2020,KS,33885,309158,1338,7142,402,7,8480,343043,1399,15.78%,32084
1098,8/14/2020,NJ,187164,2242677,570,25581,15843,10,26151,2429841,33223,2.18%,138098
1138,8/13/2020,KS,32547,302016,0,0,395,0,0,334563,1367,0.00%,30785
1154,8/13/2020,NJ,186594,2217096,656,27018,15833,8,27674,2403690,33223,2.37%,137538
1194,8/12/2020,KS,32547,302016,817,7077,395,8,7894,334563,1367,10.35%,30785
1210,8/12/2020,NJ,185938,2190078,463,25243,15825,9,25706,2376016,33223,1.80%,136890
1250,8/11/2020,KS,31730,294939,0,0,387,0,0,326669,1319,0.00%,30024
1266,8/11/2020,NJ,185475,2164835,444,25820,15816,12,26264,2350310,33223,1.69%,136436
1306,8/10/2020,KS,31730,294939,1092,9065,387,7,10157,326669,1319,10.75%,30024
1322,8/10/2020,NJ,185031,2139015,258,21936,15804,4,22194,2324046,33013,1.16%,136214
1362,8/9/2020,KS,30638,285874,0,0,380,0,0,316512,1293,0.00%,28965
1378,8/9/2020,NJ,184773,2117079,344,48716,15800,5,49060,2301852,32977,0.70%,135996
1418,8/8/2020,KS,30638,285874,0,0,380,0,0,316512,1293,0.00%,28965
1434,8/8/2020,NJ,184429,2068363,368,-368,15795,9,0,2252792,32956,inf%,135678
1474,8/7/2020,KS,30638,285874,921,6873,380,12,7794,316512,1293,11.82%,28965
1490,8/7/2020,NJ,184061,2068731,360,22187,15786,11,22547,2252792,32956,1.60%,135319
1530,8/6/2020,KS,29717,279001,0,0,368,0,0,308718,1254,0.00%,28095
1546,8/6/2020,NJ,183701,2046544,374,42853,15775,7,43227,2230245,32811,0.87%,135115
1586,8/5/2020,KS,29717,279001,841,6038,368,3,6879,308718,1254,12.23%,28095
1602,8/5/2020,NJ,183327,2003691,357,21725,15768,7,22082,2187018,32749,1.62%,134810
1642,8/4/2020,KS,28876,272963,0,0,365,0,0,301839,1196,0.00%,27315
1658,8/4/2020,NJ,182970,1981966,356,0,15761,11,356,2164936,32697,100.00%,134512
1698,8/3/2020,KS,28876,272963,1064,8268,365,7,9332,301839,1196,11.40%,27315
1714,8/3/2020,NJ,182614,1981966,264,18438,15750,10,18702,2164580,32660,1.41%,134204
1754,8/2/2020,KS,27812,264695,0,0,358,0,0,292507,1178,0.00%,26276
1770,8/2/2020,NJ,182350,1963528,321,48859,15740,6,49180,2145878,32475,0.65%,134135
1810,8/1/2020,KS,27812,264695,0,0,358,0,0,292507,1178,0.00%,26276
1826,8/1/2020,NJ,182029,1914669,369,0,15734,12,369,2096698,32475,100.00%,133820
1866,7/31/2020,KS,27812,264695,942,6616,358,9,7558,292507,1178,12.46%,26276
1882,7/31/2020,NJ,181660,1914669,690,36075,15722,11,36765,2096329,32475,1.88%,133463
1922,7/30/2020,KS,26870,258079,0,0,349,0,0,284949,1149,0.00%,25372
1938,7/30/2020,NJ,180970,1878594,204,16678,15711,11,16882,2059564,32423,1.21%,132836
1978,7/29/2020,KS,26870,258079,698,5315,349,14,6013,284949,1149,11.61%,25372
1994,7/29/2020,NJ,180766,1861916,471,57907,15700,18,58378,2042682,32365,0.81%,132701
2034,7/28/2020,KS,26172,252764,0,0,335,0,0,278936,1108,0.00%,24729
2050,7/28/2020,NJ,180295,1804009,483,-20,15682,22,463,1984304,32313,104.32%,132300
2090,7/27/2020,KS,26172,252764,1063,-94,335,9,969,278936,1108,109.70%,24729
2106,7/27/2020,NJ,179812,1804029,449,30103,15660,17,30552,1983841,32275,1.47%,131877
2146,7/26/2020,KS,25109,252858,0,0,326,0,0,277967,1077,0.00%,23706
2162,7/26/2020,NJ,179363,1773926,505,64627,15643,12,65132,1953289,32133,0.78%,131587
2202,7/25/2020,KS,25109,252858,0,0,326,0,0,277967,1077,0.00%,23706
2218,7/25/2020,NJ,178858,1709299,513,0,15631,11,513,1888157,32061,100.00%,131166
2258,7/24/2020,KS,25109,252858,1005,8276,326,18,9281,277967,1077,10.83%,23706
2274,7/24/2020,NJ,178345,1709299,458,27548,15620,35,28006,1887644,32001,1.64%,130724
2314,7/23/2020,KS,24104,244582,0,0,308,0,0,268686,1050,0.00%,22746
2330,7/23/2020,NJ,177887,1681751,242,18467,15585,23,18709,1859638,31925,1.29%,130377
2370,7/22/2020,KS,24104,244582,770,6385,308,1,7155,268686,1050,10.76%,22746
2386,7/22/2020,NJ,177645,1663284,389,22585,15562,24,22974,1840929,31850,1.69%,130233
2426,7/21/2020,KS,23334,238197,0,0,307,0,0,261531,1016,0.00%,22011
2442,7/21/2020,NJ,177256,1640699,293,14788,15538,22,15081,1817955,31781,1.94%,129937
2482,7/20/2020,KS,23334,238197,1369,10809,307,8,12178,261531,1016,11.24%,22011
2498,7/20/2020,NJ,176963,1625911,180,11557,15516,10,11737,1802874,31448,1.53%,129999
2538,7/19/2020,KS,21965,227388,0,0,299,0,0,249353,983,0.00%,20683
2554,7/19/2020,NJ,176783,1614354,-31,9718,15506,8,9687,1791137,31405,-0.32%,129872
2594,7/18/2020,KS,21965,227388,0,0,299,0,0,249353,983,0.00%,20683
2610,7/18/2020,NJ,176814,1604636,263,12259,15498,15,12522,1781450,31400,2.10%,129916
2650,7/17/2020,KS,21965,227388,1032,8947,299,0,9979,249353,983,10.34%,20683
2666,7/17/2020,NJ,176551,1592377,50,8974,15483,19,9024,1768928,31400,0.55%,129668
2706,7/16/2020,KS,20933,218441,0,0,299,0,0,239374,948,0.00%,19686
2722,7/16/2020,NJ,176501,1583403,223,17334,15464,31,17557,1759904,31400,1.27%,129637
2762,7/15/2020,KS,20933,218441,875,7324,299,11,8199,239374,948,10.67%,19686
2778,7/15/2020,NJ,176278,1566069,363,20753,15433,25,21116,1742347,31400,1.72%,129445
2818,7/14/2020,KS,20058,211117,0,0,288,0,0,231175,920,0.00%,18850
2834,7/14/2020,NJ,175915,1545316,393,20453,15408,22,20846,1721231,31318,1.89%,129189
2874,7/13/2020,KS,20058,211117,1447,11949,288,4,13396,231175,920,10.80%,18850
2890,7/13/2020,NJ,175522,1524863,224,14557,15386,19,14781,1700385,31261,1.52%,128875
2930,7/12/2020,KS,18611,199168,0,0,284,0,0,217779,905,0.00%,17422
2946,7/12/2020,NJ,175298,1510306,339,23981,15367,16,24320,1685604,31190,1.39%,128741
2986,7/11/2020,KS,18611,199168,0,0,284,0,0,217779,905,0.00%,17422
3002,7/11/2020,NJ,174959,1486325,331,37795,15351,46,38126,1661284,31092,0.87%,128516
3042,7/10/2020,KS,18611,199168,993,8304,284,2,9297,217779,905,10.68%,17422
3058,7/10/2020,NJ,174628,1448530,388,23353,15305,31,23741,1623158,31014,1.63%,128309
3098,7/9/2020,KS,17618,190864,0,0,282,0,0,208482,879,0.00%,16457
3114,7/9/2020,NJ,174240,1425177,201,21368,15274,25,21569,1599417,30938,0.93%,128028
3154,7/8/2020,KS,17618,190864,717,5546,282,2,6263,208482,879,11.45%,16457
3170,7/8/2020,NJ,174039,1403809,161,17554,15249,52,17715,1577848,30844,0.91%,127946
3210,7/7/2020,KS,16901,185318,0,0,280,0,0,202219,859,0.00%,15762
3226,7/7/2020,NJ,173878,1386255,267,10657,15197,53,10924,1560133,30774,2.44%,127907
3266,7/6/2020,KS,16901,185318,982,9676,280,3,10658,202219,859,9.21%,15762
3282,7/6/2020,NJ,173611,1375598,209,14360,15144,19,14569,1549209,30729,1.43%,127738
3322,7/5/2020,KS,15919,175642,0,0,277,0,0,191561,842,0.00%,14800
3338,7/5/2020,NJ,173402,1361238,369,25723,15125,22,26092,1534640,30660,1.41%,127617
3378,7/4/2020,KS,15919,175642,0,0,277,0,0,191561,842,0.00%,14800
3394,7/4/2020,NJ,173033,1335515,291,22756,15103,25,23047,1508548,30565,1.26%,127365
3434,7/3/2020,KS,15919,175642,929,7459,277,5,8388,191561,842,11.08%,14800
3450,7/3/2020,NJ,172742,1312759,386,21202,15078,58,21588,1485501,30464,1.79%,127200
3490,7/2/2020,KS,14990,168183,0,0,272,0,0,183173,834,0.00%,13884
3506,7/2/2020,NJ,172356,1291557,428,20548,15020,27,20976,1463913,30383,2.04%,126953
3546,7/1/2020,KS,14990,168183,547,5901,272,2,6448,183173,834,8.48%,13884
3562,7/1/2020,NJ,171928,1271009,261,20302,14993,43,20563,1442937,30300,1.27%,126635
3602,6/30/2020,KS,14443,162282,0,0,270,0,0,176725,794,0.00%,13379
3618,6/30/2020,NJ,171667,1250707,395,17995,14950,43,18390,1422374,30213,2.15%,126504
3658,6/29/2020,KS,14443,162282,905,7961,270,6,8866,176725,794,10.21%,13379
3674,6/29/2020,NJ,171272,1232712,90,16061,14907,19,16151,1403984,30163,0.56%,126202
3714,6/28/2020,KS,13538,154321,0,0,264,0,0,167859,779,0.00%,12495
3730,6/28/2020,NJ,171182,1216651,309,20274,14888,27,20583,1387833,30092,1.50%,126202
3770,6/27/2020,KS,13538,154321,0,0,264,0,0,167859,779,0.00%,12495
3786,6/27/2020,NJ,170873,1196377,289,20289,14861,36,20578,1367250,29967,1.40%,126045
3826,6/26/2020,KS,13538,154321,568,5586,264,3,6154,167859,779,9.23%,12495
3842,6/26/2020,NJ,170584,1176088,388,25374,14825,43,25762,1346672,29855,1.51%,125904
3882,6/25/2020,KS,12970,148735,0,0,261,0,0,161705,747,0.00%,11962
3898,6/25/2020,NJ,170196,1150714,304,20961,14782,23,21265,1320910,29740,1.43%,125674
3938,6/24/2020,KS,12970,148735,505,6187,261,2,6692,161705,747,7.55%,11962
3954,6/24/2020,NJ,169892,1129753,158,16036,14759,46,16194,1299645,29627,0.98%,125506
3994,6/23/2020,KS,12465,142548,0,0,259,0,0,155013,722,0.00%,11484
4010,6/23/2020,NJ,169734,1113717,319,15733,14713,56,16052,1283451,29517,1.99%,125504
4050,6/22/2020,KS,12465,142548,406,6958,259,5,7364,155013,722,5.51%,11484
4066,6/22/2020,NJ,169415,1097984,273,22159,14657,28,22432,1267399,29522,1.22%,125236
4106,6/21/2020,KS,12059,135590,0,0,254,0,0,147649,715,0.00%,11090
4122,6/21/2020,NJ,169142,1075825,308,25786,14629,15,26094,1244967,29450,1.18%,125063
4162,6/20/2020,KS,12059,135590,0,0,254,0,0,147649,715,0.00%,11090
4178,6/20/2020,NJ,168834,1050039,338,24192,14614,23,24530,1218873,29318,1.38%,124902
4218,6/19/2020,KS,12059,135590,378,5147,254,7,5525,147649,715,6.84%,11090
4234,6/19/2020,NJ,168496,1025847,389,22220,14591,35,22609,1194343,29209,1.72%,124696
4274,6/18/2020,KS,11681,130443,0,0,247,0,0,142124,696,0.00%,10738
4290,6/18/2020,NJ,168107,1003627,404,23489,14556,32,23893,1171734,29101,1.69%,124450
4330,6/17/2020,KS,11681,130443,262,4900,247,2,5162,142124,696,5.08%,10738
4346,6/17/2020,NJ,167703,980138,277,15782,14524,42,16059,1147841,28966,1.72%,124213
4386,6/16/2020,KS,11419,125543,0,0,245,0,0,136962,676,0.00%,10498
4402,6/16/2020,NJ,167426,964356,323,15376,14482,52,15699,1131782,28872,2.06%,124072
4442,6/15/2020,KS,11419,125543,372,7438,245,2,7810,136962,676,4.76%,10498
4458,6/15/2020,NJ,167103,948980,222,18245,14430,52,18467,1116083,28819,1.20%,123854
4498,6/14/2020,KS,11047,118105,0,0,243,0,0,129152,667,0.00%,10137
4514,6/14/2020,NJ,166881,930735,276,19125,14378,37,19401,1097616,28714,1.42%,123789
4554,6/13/2020,KS,11047,118105,0,0,243,0,0,129152,667,0.00%,10137
4570,6/13/2020,NJ,166605,911610,441,22378,14341,103,22819,1078215,28606,1.93%,123658
4610,6/12/2020,KS,11047,118105,235,5175,243,3,5410,129152,667,4.34%,10137
4626,6/12/2020,NJ,166164,889232,348,24255,14238,49,24603,1055396,28509,1.41%,123417
4666,6/11/2020,KS,10812,112930,0,0,240,0,0,123742,657,0.00%,9915
4682,6/11/2020,NJ,165816,864977,470,21389,14189,67,21859,1030793,28376,2.15%,123251
4722,6/10/2020,KS,10812,112930,162,4071,240,4,4233,123742,657,3.83%,9915
4738,6/10/2020,NJ,165346,843588,550,18887,14122,76,19437,1008934,28207,2.83%,123017
4778,6/9/2020,KS,10650,108859,0,0,236,0,0,119509,625,0.00%,9789
4794,6/9/2020,NJ,164796,824701,299,14109,14046,93,14408,989497,28036,2.08%,122714
4834,6/8/2020,KS,10650,108859,257,5599,236,4,5856,119509,625,4.39%,9789
4850,6/8/2020,NJ,164497,810592,333,14331,13953,39,14664,975089,27941,2.27%,122603
4890,6/7/2020,KS,10393,103260,0,0,232,0,0,113653,612,0.00%,9549
4906,6/7/2020,NJ,164164,796261,271,17138,13914,71,17409,960425,27824,1.56%,122426
4946,6/6/2020,KS,10393,103260,0,0,232,0,0,113653,612,0.00%,9549
4962,6/6/2020,NJ,163893,779123,557,23568,13843,58,24125,943016,27641,2.31%,122409
5002,6/5/2020,KS,10393,103260,223,5377,232,10,5600,113653,612,3.98%,9549
5018,6/5/2020,NJ,163336,755555,806,60356,13785,82,61162,918891,27433,1.32%,122118
5058,6/4/2020,KS,10170,97883,0,0,222,0,0,108053,592,0.00%,9356
5074,6/4/2020,NJ,162530,695199,462,19847,13703,95,20309,857729,27231,2.27%,121596
5114,6/3/2020,KS,10170,97883,159,4582,222,5,4741,108053,592,3.35%,9356
5130,6/3/2020,NJ,162068,675352,523,19220,13608,112,19743,837420,27008,2.65%,121452
5170,6/2/2020,KS,10011,93301,0,8071,217,0,8071,103312,555,0.00%,9239
5186,6/2/2020,NJ,161545,656132,627,21450,13496,52,22077,817677,26815,2.84%,121234
5226,6/1/2020,KS,10011,85230,292,0,217,9,292,95241,547,100.00%,9247
5242,6/1/2020,NJ,160918,634682,473,48982,13444,26,49455,795600,26703,0.96%,120771
5282,5/31/2020,KS,9719,85230,0,0,208,0,0,94949,547,0.00%,8964
5298,5/31/2020,NJ,160445,585700,837,0,13418,67,837,746145,26560,100.00%,120467
5338,5/30/2020,KS,9719,85230,0,0,208,0,0,94949,547,0.00%,8964
5354,5/30/2020,NJ,159608,585700,764,28133,13351,106,28897,745308,26301,2.64%,119956
5394,5/29/2020,KS,9719,85230,382,10079,208,3,10461,94949,547,3.65%,8964
5410,5/29/2020,NJ,158844,557567,1029,29525,13245,135,30554,716411,26084,3.37%,119515
5450,5/28/2020,KS,9337,75151,0,0,205,0,0,84488,534,0.00%,8598
5466,5/28/2020,NJ,157815,528042,1187,24345,13110,67,25532,685857,25804,4.65%,118901
5506,5/27/2020,KS,9337,75151,119,2970,205,17,3089,84488,534,3.85%,8598
5522,5/27/2020,NJ,156628,503697,864,23569,13043,151,24433,660325,25552,3.54%,118033
5562,5/26/2020,KS,9218,72181,0,0,188,0,0,81399,493,0.00%,8537
5578,5/26/2020,NJ,155764,480128,672,11423,12892,52,12095,635892,25384,5.56%,117488
5618,5/25/2020,KS,9218,72181,260,4705,188,3,4965,81399,493,5.24%,8537
5634,5/25/2020,NJ,155092,468705,938,19052,12840,15,19990,623797,25253,4.69%,116999
5674,5/24/2020,KS,8958,67476,0,0,185,0,0,76434,485,0.00%,8288
5690,5/24/2020,NJ,154154,449653,1050,24022,12825,54,25072,603807,25040,4.19%,116289
5730,5/23/2020,KS,8958,67476,0,0,185,0,0,76434,485,0.00%,8288
5746,5/23/2020,NJ,153104,425631,385,23036,12771,99,23421,578735,24762,1.64%,115571
5786,5/22/2020,KS,8958,67476,419,4812,185,7,5231,76434,485,8.01%,8288
5802,5/22/2020,NJ,152719,402595,1247,9793,12672,148,11040,555314,24491,11.30%,115556
5842,5/21/2020,KS,8539,62664,0,0,178,0,0,71203,473,0.00%,7888
5858,5/21/2020,NJ,151472,392802,1073,11858,12524,102,12931,544274,24236,8.30%,114712
5898,5/20/2020,KS,8539,62664,199,4014,178,5,4213,71203,473,4.72%,7888
5914,5/20/2020,NJ,150399,380944,1386,9775,12422,168,11161,531343,23945,12.42%,114032
5954,5/19/2020,KS,8340,58650,0,0,173,0,0,66990,465,0.00%,7702
5970,5/19/2020,NJ,149013,371169,974,13639,12254,152,14613,520182,23657,6.67%,113102
6010,5/18/2020,KS,8340,58650,454,4944,173,1,5398,66990,465,8.41%,7702
6026,5/18/2020,NJ,148039,357530,1705,16299,12102,83,18004,505569,23496,9.47%,112441
6066,5/17/2020,KS,7886,53706,0,0,172,0,0,61592,443,0.00%,7271
6082,5/17/2020,NJ,146334,341231,1245,11096,12019,110,12341,487565,23299,10.09%,111016
6122,5/16/2020,KS,7886,53706,0,0,172,0,0,61592,443,0.00%,7271
6138,5/16/2020,NJ,145089,330135,1184,11068,11909,115,12252,475224,22939,9.66%,110241
6178,5/15/2020,KS,7886,53706,418,3546,172,8,3964,61592,443,10.54%,7271
6194,5/15/2020,NJ,143905,319067,1201,10075,11794,197,11276,462972,15642,10.65%,116469
6234,5/14/2020,KS,7468,50160,0,0,164,0,0,57628,422,0.00%,6882
6250,5/14/2020,NJ,142704,308992,1144,9102,11597,253,10246,451696,15642,11.17%,115465
6290,5/13/2020,KS,7468,50160,352,3167,164,6,3519,57628,422,10.00%,6882
6306,5/13/2020,NJ,141560,299890,817,7573,11344,202,8390,441450,15642,9.74%,114574
6346,5/12/2020,KS,7116,46993,0,0,158,0,0,54109,376,0.00%,6582
6362,5/12/2020,NJ,140743,292317,798,6329,11142,212,7127,433060,15642,11.20%,113959
6402,5/11/2020,KS,7116,46993,168,1436,158,1,1604,54109,376,10.47%,6582
6418,5/11/2020,NJ,139945,285988,1413,112073,10930,60,113486,425933,15642,1.25%,113373
6458,5/10/2020,KS,6948,45557,197,2375,157,0,2572,52505,371,7.66%,6420
6474,5/10/2020,NJ,138532,173915,1447,5794,10870,151,7241,312447,15642,19.98%,112020
6514,5/9/2020,KS,6751,43182,250,1975,157,5,2225,49933,350,11.24%,6244
6530,5/9/2020,NJ,137085,168121,1631,4816,10719,177,6447,305206,15642,25.30%,110724
6570,5/8/2020,KS,6501,41207,357,2529,152,5,2886,47708,332,12.37%,6017
6586,5/8/2020,NJ,135454,163305,1819,4282,10542,170,6101,298759,15642,29.81%,109270
6626,5/7/2020,KS,6144,38678,410,2298,147,3,2708,44822,323,15.14%,5674
6642,5/7/2020,NJ,133635,159023,1745,1993,10372,264,3738,292658,15642,46.68%,107621
6682,5/6/2020,KS,5734,36380,276,1746,144,7,2022,42114,318,13.65%,5272
6698,5/6/2020,NJ,131890,157030,1297,0,10108,323,1297,288920,15642,100.00%,106140
6738,5/5/2020,KS,5458,34634,213,1276,137,1,1489,40092,296,14.30%,5025
6754,5/5/2020,NJ,130593,157030,2324,8079,9785,341,10403,287623,15642,22.34%,105166
6794,5/4/2020,KS,5245,33358,215,1610,136,2,1825,38603,291,11.78%,4818
6810,5/4/2020,NJ,128269,148951,1525,629,9444,62,2154,277220,15642,70.80%,103183
6850,5/3/2020,KS,5030,31748,284,1552,134,3,1836,36778,286,15.47%,4610
6866,5/3/2020,NJ,126744,148322,3027,9727,9382,154,12754,275066,15642,23.73%,101720
6906,5/2/2020,KS,4746,30196,297,1611,131,1,1908,34942,286,15.57%,4329
6922,5/2/2020,NJ,123717,138595,2527,3240,9228,227,5767,262312,15642,43.82%,98847
6962,5/1/2020,KS,4449,28585,211,1197,130,1,1408,33034,280,14.99%,4039
6978,5/1/2020,NJ,121190,135355,2538,6089,9001,334,8627,256545,15642,29.42%,96547
7018,4/30/2020,KS,4238,27388,500,1668,129,4,2168,31626,272,23.06%,3837
7034,4/30/2020,NJ,118652,129266,2388,4212,8667,481,6600,247918,15642,36.18%,94343
7074,4/29/2020,KS,3738,25720,247,1121,125,1,1368,29458,266,18.06%,3347
7090,4/29/2020,NJ,116264,125054,2408,4551,8186,349,6959,241318,15642,34.60%,92436
7130,4/28/2020,KS,3491,24599,163,760,124,4,923,28090,0,17.66%,3367
7146,4/28/2020,NJ,113856,120503,2668,3916,7837,428,6584,234359,15642,40.52%,90377
7186,4/27/2020,KS,3328,23839,154,786,120,2,940,27167,0,16.38%,3208
7202,4/27/2020,NJ,111188,116587,2150,2481,7409,139,4631,227775,0,46.43%,103779
7242,4/26/2020,KS,3174,23053,118,910,118,1,1028,26227,0,11.48%,3056
7258,4/26/2020,NJ,109038,114106,3515,5943,7270,101,9458,223144,0,37.16%,101768
7298,4/25/2020,KS,3056,22143,279,1332,117,6,1611,25199,0,17.32%,2939
7314,4/25/2020,NJ,105523,108163,3327,4397,7169,280,7724,213686,0,43.07%,98354
7354,4/24/2020,KS,2777,20811,295,1975,111,-1,2270,23588,0,13.00%,2666
7370,4/24/2020,NJ,102196,103766,2207,3607,6889,279,5814,205962,0,37.96%,95307
7410,4/23/2020,KS,2482,18836,271,844,112,2,1115,21318,0,24.30%,2370
7426,4/23/2020,NJ,99989,100159,4124,4365,6610,332,8489,200148,0,48.58%,93379
7466,4/22/2020,KS,2211,17992,186,916,110,3,1102,20203,0,16.88%,2101
7482,4/22/2020,NJ,95865,95794,3478,3355,6278,343,6833,191659,0,50.90%,89587
7522,4/21/2020,KS,2025,17076,39,301,107,7,340,19101,0,11.47%,1918
7538,4/21/2020,NJ,92387,92439,3581,3188,5935,414,6769,184826,0,52.90%,86452
7578,4/20/2020,KS,1986,16775,137,494,100,8,631,18761,0,21.71%,1886
7594,4/20/2020,NJ,88806,89251,3505,3864,5521,208,7369,178057,0,47.56%,83285
7634,4/19/2020,KS,1849,16281,59,395,92,6,454,18130,0,13.00%,1757
7650,4/19/2020,NJ,85301,85387,3881,4271,5313,171,8152,170688,0,47.61%,79988
7690,4/18/2020,KS,1790,15886,85,690,86,2,775,17676,0,10.97%,1704
7706,4/18/2020,NJ,81420,81116,2953,2134,5142,286,5087,162536,0,58.05%,76278
7746,4/17/2020,KS,1705,15196,117,662,84,4,779,16901,0,15.02%,1621
7762,4/17/2020,NJ,78467,78982,3150,2469,4856,365,5619,157449,0,56.06%,73611
7802,4/16/2020,KS,1588,14534,94,1360,80,4,1454,16122,0,6.46%,1508
7818,4/16/2020,NJ,75317,76513,4287,3522,4491,421,7809,151830,0,54.90%,70826
7858,4/15/2020,KS,1494,13174,68,453,76,7,521,14668,0,13.05%,1418
7874,4/15/2020,NJ,71030,72991,2206,2041,4070,409,4247,144021,0,51.94%,66960
7914,4/14/2020,KS,1426,12721,50,233,69,7,283,14147,0,17.67%,1357
7930,4/14/2020,NJ,68824,70950,4240,6065,3661,411,10305,139774,0,41.15%,65163
7970,4/13/2020,KS,1376,12488,39,572,62,6,611,13864,0,6.38%,1314
7986,4/13/2020,NJ,64584,64885,2734,0,3250,165,2734,129469,0,100.00%,61334
8026,4/12/2020,KS,1337,11916,69,841,56,1,910,13253,0,7.58%,1281
8042,4/12/2020,NJ,61850,64885,3699,2843,3085,240,6542,126735,0,56.54%,58765
8082,4/11/2020,KS,1268,11075,102,827,55,5,929,12343,0,10.98%,1213
8098,4/11/2020,NJ,58151,62042,3563,3107,2845,324,6670,120193,0,53.42%,55306
8138,4/10/2020,KS,1166,10248,60,579,50,8,639,11414,0,9.39%,1116
8154,4/10/2020,NJ,54588,58935,3561,2770,2521,285,6331,113523,682,56.25%,51385
8194,4/9/2020,KS,1106,9669,60,532,42,4,592,10775,0,10.14%,1064
8210,4/9/2020,NJ,51027,56165,3590,3186,2236,267,6776,107192,0,52.98%,48791
8250,4/8/2020,KS,1046,9137,146,523,38,11,669,10183,0,21.82%,1008
8266,4/8/2020,NJ,47437,52979,3021,2421,1969,338,5442,100416,0,55.51%,45468
8306,4/7/2020,KS,900,8614,55,375,27,2,430,9514,0,12.79%,873
8322,4/7/2020,NJ,44416,50558,3326,2616,1631,297,5942,94974,0,55.97%,42785
8362,4/6/2020,KS,845,8239,98,763,25,3,861,9084,0,11.38%,820
8378,4/6/2020,NJ,41090,47942,3585,3281,1334,150,6866,89032,0,52.21%,39756
8418,4/5/2020,KS,747,7476,49,596,22,1,645,8223,0,7.60%,725
8434,4/5/2020,NJ,37505,44661,3381,3429,1184,126,6810,82166,0,49.65%,36321
8474,4/4/2020,KS,698,6880,78,426,21,4,504,7578,0,15.48%,677
8490,4/4/2020,NJ,34124,41232,4229,3624,1058,242,7853,75356,0,53.85%,33066
8530,4/3/2020,KS,620,6454,68,395,17,4,463,7074,0,14.69%,603
8546,4/3/2020,NJ,29895,37608,4305,4088,816,136,8393,67503,0,51.29%,29079
8586,4/2/2020,KS,552,6059,70,648,13,3,718,6611,0,9.75%,539
8602,4/2/2020,NJ,25590,33520,3335,3133,680,205,6468,59110,0,51.56%,24910
8642,4/1/2020,KS,482,5411,54,415,10,1,469,5893,0,11.51%,472
8658,4/1/2020,NJ,22255,30387,3559,3310,475,110,6869,52642,0,51.81%,21780
8698,3/31/2020,KS,428,4996,60,442,9,1,502,5424,0,11.95%,419
8754,3/30/2020,KS,368,4554,49,360,8,2,409,4922,0,11.98%,360
8810,3/29/2020,KS,319,4194,58,523,6,1,581,4513,0,9.98%,313
8866,3/28/2020,KS,261,3671,59,442,5,1,501,3932,0,11.78%,256
8922,3/27/2020,KS,202,3229,34,360,4,1,394,3431,0,8.63%,198
8978,3/26/2020,KS,168,2869,42,509,3,0,551,3037,0,7.62%,165
9034,3/25/2020,KS,126,2360,28,274,3,1,302,2486,0,9.27%,123
9090,3/24/2020,KS,98,2086,16,1669,2,0,1685,2184,0,0.95%,96
9146,3/23/2020,KS,82,417,18,0,2,0,18,499,0,100.00%,80
9202,3/22/2020,KS,64,417,9,0,2,0,9,481,0,100.00%,62
9258,3/21/2020,KS,55,417,11,0,2,1,11,472,0,100.00%,53
9314,3/20/2020,KS,44,417,10,0,1,0,10,461,0,100.00%,43
9370,3/19/2020,KS,34,417,18,0,1,0,18,451,0,100.00%,33
9426,3/18/2020,KS,16,417,1,35,1,0,36,433,0,2.78%,15
9482,3/17/2020,KS,15,382,4,216,1,0,220,397,0,1.82%,14
9538,3/16/2020,KS,11,166,3,31,1,0,34,177,0,8.82%,10
9592,3/15/2020,KS,8,135,2,42,1,0,44,143,0,4.55%,7
9643,3/14/2020,KS,6,93,0,0,1,1,0,99,0,0.00%,5
9694,3/13/2020,KS,6,93,2,52,0,0,54,99,0,3.70%,6
9745,3/12/2020,KS,4,41,3,0,0,0,3,45,0,100.00%,4
9796,3/11/2020,KS,1,41,0,24,0,0,24,42,0,0.00%,1
9847,3/10/2020,KS,1,17,0,6,0,0,6,18,0,0.00%,1
9898,3/9/2020,KS,1,11,0,0,0,0,0,12,0,0.00%,1
9949,3/8/2020,KS,1,11,1,0,0,0,1,12,0,100.00%,1
10000,3/7/2020,KS,0,11,0,7,0,0,7,11,0,0.00%,0
10047,3/6/2020,KS,0,4,0,0,0,0,0,4,0,0.00%,0
10085,3/5/2020,KS,0,0,0,0,0,0,0,0,0,0.00%,0
10106,3/4/2020,KS,0,0,0,0,0,0,0,0,0,0.00%,0
10117,3/3/2020,KS,0,0,0,0,0,0,0,0,0,0.00%,0
10123,3/2/2020,KS,0,0,0,0,0,0,0,0,0,0.00%,0
10129,3/1/2020,KS,0,0,0,0,0,0,0,0,0,0.00%,0
8714,3/31/2020,NJ,18696,27077,2060,1853,365,98,3913,45773,0,52.65%,18331
8770,3/30/2020,NJ,16636,25224,3250,3008,267,49,6258,41860,0,51.93%,16369
8826,3/29/2020,NJ,13386,22216,2262,2830,218,26,5092,35602,0,44.42%,13168
8882,3/28/2020,NJ,11124,19386,2299,2839,192,51,5138,30510,0,44.75%,10932
8938,3/27/2020,NJ,8825,16547,1949,2886,141,32,4835,25372,0,40.31%,8684
8994,3/26/2020,NJ,6876,13661,2474,3209,109,28,5683,20537,0,43.53%,6767
9050,3/25/2020,NJ,4402,10452,727,2127,81,21,2854,14854,0,25.47%,4321
9106,3/24/2020,NJ,3675,8325,831,7966,60,20,8797,12000,0,9.45%,3615
9162,3/23/2020,NJ,2844,359,930,32,40,11,962,3203,0,96.67%,2804
9218,3/22/2020,NJ,1914,327,587,33,29,7,620,2241,0,94.68%,1885
9274,3/21/2020,NJ,1327,294,437,30,22,6,467,1621,0,93.58%,1305
9330,3/20/2020,NJ,890,264,148,54,16,3,202,1154,0,73.27%,874
9386,3/19/2020,NJ,742,210,315,20,13,6,335,952,0,94.03%,729
9442,3/18/2020,NJ,427,190,160,27,7,3,187,617,0,85.56%,420
9498,3/17/2020,NJ,267,163,89,43,4,2,132,430,0,67.42%,263
9554,3/16/2020,NJ,178,120,80,0,2,0,80,298,0,100.00%,176
9607,3/15/2020,NJ,98,120,48,23,2,1,71,218,0,67.61%,96
9658,3/14/2020,NJ,50,97,0,0,1,0,0,147,0,0.00%,49
9709,3/13/2020,NJ,50,97,20,23,1,0,43,147,0,46.51%,49
9760,3/12/2020,NJ,30,74,6,17,1,0,23,104,0,26.09%,29
9811,3/11/2020,NJ,24,57,9,13,1,1,22,81,0,40.91%,23
9862,3/10/2020,NJ,15,44,4,9,0,0,13,59,0,30.77%,15
9913,3/9/2020,NJ,11,35,5,4,0,0,9,46,0,55.56%,11
9964,3/8/2020,NJ,6,31,2,31,0,0,33,37,0,6.06%,6
10015,3/7/2020,NJ,4,0,3,0,0,0,3,4,0,100.00%,4
10056,3/6/2020,NJ,1,0,0,0,0,0,0,1,0,0.00%,1
10085,3/5/2020,NJ,1,0,1,0,0,0,1,1,0,100.00%,1
10106,3/4/2020,NJ,0,0,0,0,0,0,0,0,0,0.00%,0
10117,3/3/2020,NJ,0,0,0,0,0,0,0,0,0,0.00%,0
10123,3/2/2020,NJ,0,0,0,0,0,0,0,0,0,0.00%,0
10129,3/1/2020,NJ,0,0,0,0,0,0,0,0,0,0.00%,0
10134,2/29/2020,NJ,0,0,0,0,0,0,0,0,0,0.00%,0
10138,2/28/2020,NJ,0,0,0,0,0,0,0,0,0,0.00%,0
10142,2/27/2020,NJ,0,0,0,0,0,0,0,0,0,0.00%,0
10146,2/26/2020,NJ,0,0,0,0,0,0,0,0,0,0.00%,0
10149,2/25/2020,NJ,0,0,0,0,0,0,0,0,0,0.00%,0
10152,2/24/2020,NJ,0,0,0,0,0,0,0,0,0,0.00%,0
10155,2/23/2020,NJ,0,0,0,0,0,0,0,0,0,0.00%,0
10158,2/22/2020,NJ,0,0,0,0,0,0,0,0,0,0.00%,0
10161,2/21/2020,NJ,0,0,0,0,0,0,0,0,0,0.00%,0
10164,2/20/2020,NJ,0,0,0,0,0,0,0,0,0,0.00%,0
10167,2/19/2020,NJ,0,0,0,0,0,0,0,0,0,0.00%,0
10170,2/18/2020,NJ,0,0,0,0,0,0,0,0,0,0.00%,0
10173,2/17/2020,NJ,0,0,0,0,0,0,0,0,0,0.00%,0
10176,2/16/2020,NJ,0,0,0,0,0,0,0,0,0,0.00%,0
10179,2/15/2020,NJ,0,0,0,0,0,0,0,0,0,0.00%,0
10182,2/14/2020,NJ,0,0,0,0,0,0,0,0,0,0.00%,0
10185,2/13/2020,NJ,0,0,0,0,0,0,0,0,0,0.00%,0
10188,2/12/2020,NJ,0,0,0,0,0,0,0,0,0,0.00%,0
10191,2/11/2020,NJ,0,0,0,0,0,0,0,0,0,0.00%,0
10194,2/10/2020,NJ,0,0,0,0,0,0,0,0,0,0.00%,0
